"filename", "language", "Dart", "Todo", "comment", "blank", "total"
"d:\Flutterrrr\FlutterProjects\windows_widgets\lib\TODO.todo", "Todo", 0, 66, 0, 2, 68
"d:\Flutterrrr\FlutterProjects\windows_widgets\lib\config\app.dart", "Dart", 97, 0, 3, 17, 117
"d:\Flutterrrr\FlutterProjects\windows_widgets\lib\config\enums\open_item_command_type.dart", "Dart", 4, 0, 0, 1, 5
"d:\Flutterrrr\FlutterProjects\windows_widgets\lib\config\enums\side_item_type.dart", "Dart", 21, 0, 0, 3, 24
"d:\Flutterrrr\FlutterProjects\windows_widgets\lib\config\extensions\bool_exensions.dart", "Dart", 9, 0, 0, 1, 10
"d:\Flutterrrr\FlutterProjects\windows_widgets\lib\config\extensions\build_context_extensions.dart", "Dart", 77, 0, 2, 6, 85
"d:\Flutterrrr\FlutterProjects\windows_widgets\lib\config\extensions\color_extensions.dart", "Dart", 34, 0, 5, 9, 48
"d:\Flutterrrr\FlutterProjects\windows_widgets\lib\config\extensions\double_exensions.dart", "Dart", 9, 0, 0, 1, 10
"d:\Flutterrrr\FlutterProjects\windows_widgets\lib\config\extensions\sidebar_extensions.dart", "Dart", 33, 0, 0, 6, 39
"d:\Flutterrrr\FlutterProjects\windows_widgets\lib\config\extensions\string_extensions.dart", "Dart", 37, 0, 5, 13, 55
"d:\Flutterrrr\FlutterProjects\windows_widgets\lib\config\native_plugins\file_icon_plugin.dart", "Dart", 15, 0, 1, 3, 19
"d:\Flutterrrr\FlutterProjects\windows_widgets\lib\config\native_plugins\url_icon_plugin.dart", "Dart", 27, 0, 1, 4, 32
"d:\Flutterrrr\FlutterProjects\windows_widgets\lib\config\native_plugins\window_aero_blur.dart", "Dart", 7, 0, 0, 3, 10
"d:\Flutterrrr\FlutterProjects\windows_widgets\lib\config\theme\sidebar_theme.dart", "Dart", 63, 0, 4, 6, 73
"d:\Flutterrrr\FlutterProjects\windows_widgets\lib\config\theme\themes\sidebar_checkbox_theme.dart", "Dart", 26, 0, 0, 2, 28
"d:\Flutterrrr\FlutterProjects\windows_widgets\lib\config\theme\themes\sidebar_dialog_theme.dart", "Dart", 18, 0, 0, 2, 20
"d:\Flutterrrr\FlutterProjects\windows_widgets\lib\config\theme\themes\sidebar_divider_theme.dart", "Dart", 7, 0, 0, 2, 9
"d:\Flutterrrr\FlutterProjects\windows_widgets\lib\config\theme\themes\sidebar_extensions_theme.dart", "Dart", 11, 0, 0, 2, 13
"d:\Flutterrrr\FlutterProjects\windows_widgets\lib\config\theme\themes\sidebar_icon_button_theme.dart", "Dart", 17, 0, 0, 2, 19
"d:\Flutterrrr\FlutterProjects\windows_widgets\lib\config\theme\themes\sidebar_icon_theme.dart", "Dart", 3, 0, 0, 2, 5
"d:\Flutterrrr\FlutterProjects\windows_widgets\lib\config\theme\themes\sidebar_input_decoration_theme.dart", "Dart", 50, 0, 0, 2, 52
"d:\Flutterrrr\FlutterProjects\windows_widgets\lib\config\theme\themes\sidebar_popup_menu_theme.dart", "Dart", 19, 0, 0, 2, 21
"d:\Flutterrrr\FlutterProjects\windows_widgets\lib\config\theme\themes\sidebar_radio_theme.dart", "Dart", 7, 0, 0, 2, 9
"d:\Flutterrrr\FlutterProjects\windows_widgets\lib\config\theme\themes\sidebar_slider_theme.dart", "Dart", 12, 0, 0, 2, 14
"d:\Flutterrrr\FlutterProjects\windows_widgets\lib\config\theme\themes\sidebar_switch_theme.dart", "Dart", 12, 0, 0, 2, 14
"d:\Flutterrrr\FlutterProjects\windows_widgets\lib\config\theme\themes\sidebar_text_theme.dart", "Dart", 29, 0, 1, 2, 32
"d:\Flutterrrr\FlutterProjects\windows_widgets\lib\config\theme\themes\sidebar_tooltip_theme.dart", "Dart", 17, 0, 0, 2, 19
"d:\Flutterrrr\FlutterProjects\windows_widgets\lib\config\utils\constants.dart", "Dart", 19, 0, 1, 19, 39
"d:\Flutterrrr\FlutterProjects\windows_widgets\lib\config\utils\custom_icons.dart", "Dart", 22, 0, 1, 4, 27
"d:\Flutterrrr\FlutterProjects\windows_widgets\lib\config\utils\generate.dart", "Dart", 8, 0, 0, 2, 10
"d:\Flutterrrr\FlutterProjects\windows_widgets\lib\config\utils\global_colors.dart", "Dart", 8, 0, 0, 3, 11
"d:\Flutterrrr\FlutterProjects\windows_widgets\lib\config\utils\identical.dart", "Dart", 8, 0, 0, 2, 10
"d:\Flutterrrr\FlutterProjects\windows_widgets\lib\config\utils\picker.dart", "Dart", 93, 0, 6, 16, 115
"d:\Flutterrrr\FlutterProjects\windows_widgets\lib\config\utils\shadows.dart", "Dart", 22, 0, 2, 3, 27
"d:\Flutterrrr\FlutterProjects\windows_widgets\lib\config\utils\transition_animation.dart", "Dart", 75, 0, 6, 17, 98
"d:\Flutterrrr\FlutterProjects\windows_widgets\lib\config\utils\widgets\app_scaffold.dart", "Dart", 37, 0, 0, 4, 41
"d:\Flutterrrr\FlutterProjects\windows_widgets\lib\config\utils\widgets\dialog_button.dart", "Dart", 48, 0, 0, 4, 52
"d:\Flutterrrr\FlutterProjects\windows_widgets\lib\config\utils\widgets\expandable.dart", "Dart", 238, 0, 2, 24, 264
"d:\Flutterrrr\FlutterProjects\windows_widgets\lib\config\utils\widgets\fade_effect.dart", "Dart", 34, 0, 1, 4, 39
"d:\Flutterrrr\FlutterProjects\windows_widgets\lib\config\utils\widgets\global_loading.dart", "Dart", 26, 0, 0, 4, 30
"d:\Flutterrrr\FlutterProjects\windows_widgets\lib\config\utils\widgets\overflow_tooltip_text.dart", "Dart", 35, 0, 0, 7, 42
"d:\Flutterrrr\FlutterProjects\windows_widgets\lib\config\utils\widgets\right_click_menu.dart", "Dart", 148, 0, 0, 7, 155
"d:\Flutterrrr\FlutterProjects\windows_widgets\lib\config\utils\windows\window_animation_utils_mixin.dart", "Dart", 95, 0, 3, 21, 119
"d:\Flutterrrr\FlutterProjects\windows_widgets\lib\config\utils\windows\window_utils.dart", "Dart", 117, 0, 16, 30, 163
"d:\Flutterrrr\FlutterProjects\windows_widgets\lib\features\main_sidebar\data\hive_side_items_repo.dart", "Dart", 37, 0, 6, 10, 53
"d:\Flutterrrr\FlutterProjects\windows_widgets\lib\features\main_sidebar\domain\models\adapters\side_file_adapter.dart", "Dart", 29, 0, 0, 5, 34
"d:\Flutterrrr\FlutterProjects\windows_widgets\lib\features\main_sidebar\domain\models\adapters\side_folder_adapter.dart", "Dart", 26, 0, 0, 5, 31
"d:\Flutterrrr\FlutterProjects\windows_widgets\lib\features\main_sidebar\domain\models\adapters\side_url_adapter.dart", "Dart", 29, 0, 0, 5, 34
"d:\Flutterrrr\FlutterProjects\windows_widgets\lib\features\main_sidebar\domain\models\side_file.dart", "Dart", 46, 0, 0, 7, 53
"d:\Flutterrrr\FlutterProjects\windows_widgets\lib\features\main_sidebar\domain\models\side_folder.dart", "Dart", 39, 0, 2, 7, 48
"d:\Flutterrrr\FlutterProjects\windows_widgets\lib\features\main_sidebar\domain\models\side_item.dart", "Dart", 73, 0, 3, 14, 90
"d:\Flutterrrr\FlutterProjects\windows_widgets\lib\features\main_sidebar\domain\models\side_url.dart", "Dart", 78, 0, 3, 9, 90
"d:\Flutterrrr\FlutterProjects\windows_widgets\lib\features\main_sidebar\domain\side_items_repo.dart", "Dart", 9, 0, 0, 7, 16
"d:\Flutterrrr\FlutterProjects\windows_widgets\lib\features\main_sidebar\presentation\cubits\side_items_cubit.dart", "Dart", 163, 0, 15, 25, 203
"d:\Flutterrrr\FlutterProjects\windows_widgets\lib\features\main_sidebar\presentation\cubits\side_items_states.dart", "Dart", 12, 0, 0, 8, 20
"d:\Flutterrrr\FlutterProjects\windows_widgets\lib\features\main_sidebar\presentation\pages\components\dialogs\change_item_name_dialog.dart", "Dart", 86, 0, 0, 4, 90
"d:\Flutterrrr\FlutterProjects\windows_widgets\lib\features\main_sidebar\presentation\pages\components\dialogs\change_item_open_command_dialog.dart", "Dart", 99, 0, 1, 4, 104
"d:\Flutterrrr\FlutterProjects\windows_widgets\lib\features\main_sidebar\presentation\pages\components\dialogs\item_info_dialog.dart", "Dart", 94, 0, 0, 4, 98
"d:\Flutterrrr\FlutterProjects\windows_widgets\lib\features\main_sidebar\presentation\pages\components\dialogs\pick_url_dialog.dart", "Dart", 76, 0, 0, 4, 80
"d:\Flutterrrr\FlutterProjects\windows_widgets\lib\features\main_sidebar\presentation\pages\components\footer_row.dart", "Dart", 115, 0, 0, 4, 119
"d:\Flutterrrr\FlutterProjects\windows_widgets\lib\features\main_sidebar\presentation\pages\components\header_row.dart", "Dart", 127, 0, 2, 4, 133
"d:\Flutterrrr\FlutterProjects\windows_widgets\lib\features\main_sidebar\presentation\pages\components\info_dialog_row.dart", "Dart", 60, 0, 0, 4, 64
"d:\Flutterrrr\FlutterProjects\windows_widgets\lib\features\main_sidebar\presentation\pages\components\no_items_row.dart", "Dart", 32, 0, 0, 4, 36
"d:\Flutterrrr\FlutterProjects\windows_widgets\lib\features\main_sidebar\presentation\pages\components\side_button.dart", "Dart", 179, 0, 0, 16, 195
"d:\Flutterrrr\FlutterProjects\windows_widgets\lib\features\main_sidebar\presentation\pages\components\side_divider.dart", "Dart", 37, 0, 2, 4, 43
"d:\Flutterrrr\FlutterProjects\windows_widgets\lib\features\main_sidebar\presentation\pages\components\side_item_card.dart", "Dart", 246, 0, 2, 15, 263
"d:\Flutterrrr\FlutterProjects\windows_widgets\lib\features\main_sidebar\presentation\pages\components\side_small_button.dart", "Dart", 83, 0, 0, 8, 91
"d:\Flutterrrr\FlutterProjects\windows_widgets\lib\features\main_sidebar\presentation\pages\main_window.dart", "Dart", 276, 0, 8, 20, 304
"d:\Flutterrrr\FlutterProjects\windows_widgets\lib\features\settings_sidebar\data\hive_prefs_repo.dart", "Dart", 28, 0, 0, 5, 33
"d:\Flutterrrr\FlutterProjects\windows_widgets\lib\features\settings_sidebar\domain\models\adapters\prefs_adapter.dart", "Dart", 29, 0, 0, 5, 34
"d:\Flutterrrr\FlutterProjects\windows_widgets\lib\features\settings_sidebar\domain\models\prefs.dart", "Dart", 38, 0, 0, 4, 42
"d:\Flutterrrr\FlutterProjects\windows_widgets\lib\features\settings_sidebar\domain\prefs_repo.dart", "Dart", 5, 0, 0, 2, 7
"d:\Flutterrrr\FlutterProjects\windows_widgets\lib\features\settings_sidebar\presentation\cubits\prefs\prefs_cubit.dart", "Dart", 52, 0, 2, 10, 64
"d:\Flutterrrr\FlutterProjects\windows_widgets\lib\features\settings_sidebar\presentation\cubits\prefs\prefs_states.dart", "Dart", 12, 0, 0, 8, 20
"d:\Flutterrrr\FlutterProjects\windows_widgets\lib\features\settings_sidebar\presentation\pages\components\blur_row.dart", "Dart", 58, 0, 0, 4, 62
"d:\Flutterrrr\FlutterProjects\windows_widgets\lib\features\settings_sidebar\presentation\pages\components\clear_all_items_button.dart", "Dart", 59, 0, 0, 4, 63
"d:\Flutterrrr\FlutterProjects\windows_widgets\lib\features\settings_sidebar\presentation\pages\components\dialogs\prefs_save_dialog.dart", "Dart", 52, 0, 0, 4, 56
"d:\Flutterrrr\FlutterProjects\windows_widgets\lib\features\settings_sidebar\presentation\pages\components\opacity_row.dart", "Dart", 50, 0, 0, 4, 54
"d:\Flutterrrr\FlutterProjects\windows_widgets\lib\features\settings_sidebar\presentation\pages\components\padding_row.dart", "Dart", 49, 0, 0, 5, 54
"d:\Flutterrrr\FlutterProjects\windows_widgets\lib\features\settings_sidebar\presentation\pages\components\resize_row.dart", "Dart", 99, 0, 0, 4, 103
"d:\Flutterrrr\FlutterProjects\windows_widgets\lib\features\settings_sidebar\presentation\pages\components\side_slider.dart", "Dart", 124, 0, 4, 19, 147
"d:\Flutterrrr\FlutterProjects\windows_widgets\lib\features\settings_sidebar\presentation\pages\components\theme_row.dart", "Dart", 135, 0, 0, 4, 139
"d:\Flutterrrr\FlutterProjects\windows_widgets\lib\features\settings_sidebar\presentation\pages\settings_window.dart", "Dart", 193, 0, 12, 28, 233
"d:\Flutterrrr\FlutterProjects\windows_widgets\lib\main.dart", "Dart", 42, 0, 2, 12, 56
"Total", "-", 4770, 66, 124, 591, 5551